Rk,Player,Pos,"Squad
▲",Age,Born,90s,Tkl_plyr,TklW_plyr,Def 3rd_plyr,Mid 3rd_plyr,Att 3rd_plyr,Tkl_drb,Att_drb,Tkl%_drb,Lost_drb,Blocks,Sh,Pass,Int,Tkl+Int,Clr,"Err
▼"
1,Leah Williamson,DF,Arsenal,21,1997,17.8,25,17,17,6,2,8,13,61.5,5,12,4,8,30,55,36,1
2,Lia Wälti,MF,Arsenal,25,1993,11.8,35,21,14,16,5,15,33,45.5,18,18,3,15,10,45,3,0
3,Katrine Veje,"DF,FW",Arsenal,27,1991,6.9,10,7,4,3,3,3,6,50,3,5,2,3,4,14,11,0
4,Sari van Veenendaal,GK,Arsenal,28,1990,7,0,0,0,0,0,0,0,,0,0,0,0,0,0,1,0
5,Viktoria Schnaderbeck,"MF,DF",Arsenal,27,1991,1.2,3,1,2,1,0,1,1,100,0,0,0,0,1,4,2,0
6,Jessica Samuelsson,DF,Arsenal,26,1992,2.1,2,1,0,1,1,0,1,0,1,2,0,2,0,2,2,0
7,Louise Quinn,DF,Arsenal,28,1990,17.2,13,9,10,3,0,7,12,58.3,5,15,9,6,12,25,62,0
8,Pauline Peyraud-Magnin,GK,Arsenal,26,1992,13,0,0,0,0,0,0,0,,0,0,0,0,0,0,6,4
9,Jordan Nobbs,"MF,FW",Arsenal,25,1992,7.8,11,7,2,7,2,0,2,0,2,9,0,9,4,15,0,0
10,Emma Mitchell,DF,Arsenal,25,1992,9,24,14,14,8,2,9,12,75,3,6,2,4,12,36,22,0
11,Vivianne Miedema,FW,Arsenal,22,1996,19.8,21,9,2,11,8,6,14,42.9,8,18,2,16,4,25,3,0
12,Beth Mead,"FW,MF",Arsenal,23,1995,16.9,29,20,6,16,7,10,24,41.7,14,19,1,18,11,40,4,0
13,Katie McCabe,"MF,FW",Arsenal,22,1995,17.5,30,18,9,17,4,9,20,45,11,17,2,15,17,47,11,0
14,Kim Little,MF,Arsenal,28,1990,13.6,17,13,2,12,3,2,9,22.2,7,8,3,5,4,21,9,0
15,Ava Kuyken,"MF,DF",Arsenal,17,2001,1.2,3,2,1,2,0,0,1,0,1,0,0,0,3,6,1,0
16,Tabea Kemme,"FW,MF",Arsenal,26,1991,0,1,1,0,0,1,0,0,,0,0,0,0,0,1,0,0
17,Dominique Janssen,"MF,DF",Arsenal,23,1995,18.6,50,24,19,23,8,17,30,56.7,13,23,2,21,12,62,29,0
18,Amelia Hazard,"FW,MF",Arsenal,17,2000,0.3,0,0,0,0,0,0,0,,0,1,0,1,0,0,0,0
19,Ruby Grant,"MF,FW",Arsenal,16,2002,0.1,0,0,0,0,0,0,0,,0,0,0,0,1,1,0,0
20,Melisa Filis,FW,Arsenal,16,2002,0,0,0,0,0,0,0,0,,0,0,0,0,0,0,0,0
21,Lisa Evans,"DF,FW",Arsenal,26,1992,15.7,13,10,7,3,3,6,12,50,6,17,1,16,14,27,10,0
22,Daniëlle van de Donk,"MF,FW",Arsenal,26,1991,17.6,43,22,8,19,16,13,33,39.4,20,32,1,31,16,59,6,0
23,Danielle Carter,"FW,MF",Arsenal,25,1993,0.9,2,1,0,0,2,0,2,0,2,1,0,1,3,5,0,0
24,Paige Bailey-Gayle,"FW,MF",Arsenal,16,2001,1.1,3,2,1,1,1,1,1,100,0,2,0,2,1,4,0,0
25,Janni Arnth,DF,Arsenal,31,1986,2.8,0,0,0,0,0,0,0,,0,2,2,0,1,1,9,0
26,Paige Williams,DF,Birmingham City,23,1995,11.5,15,11,9,4,2,4,14,28.6,10,15,4,11,25,40,23,0
27,Ellen White,FW,Birmingham City,29,1989,7.2,2,2,0,1,1,0,0,,0,9,0,9,4,6,4,0
28,Charlie Wellings,"FW,MF",Birmingham City,20,1998,17.6,15,14,3,10,2,2,5,40,3,15,0,15,12,27,6,0
29,Claudia Walker,"FW,MF",Birmingham City,22,1996,3.2,2,2,1,0,1,0,4,0,4,4,0,4,2,4,0,0
30,Lucy Staniforth,"MF,FW",Birmingham City,25,1992,18,15,9,4,6,5,4,17,23.5,13,14,3,11,20,35,6,0
31,Harriet Scott,DF,Birmingham City,25,1993,11.4,39,28,15,19,5,7,14,50,7,13,0,13,10,49,24,0
32,Connie Scofield,MF,Birmingham City,19,1999,3.5,0,0,0,0,0,0,0,,0,0,0,0,0,0,0,0
33,Meaghan Sargeant,DF,Birmingham City,24,1994,16.9,21,14,9,11,1,10,15,66.7,5,23,11,12,18,39,47,1
34,Lucy Quinn,"FW,MF",Birmingham City,24,1993,6.5,9,4,0,8,1,2,3,66.7,1,10,1,9,4,13,3,0
35,Sarah Mayling,"FW,DF",Birmingham City,21,1997,9.3,17,10,5,8,4,9,15,60,6,13,1,12,5,22,9,0
36,Aoife Mannion,DF,Birmingham City,22,1995,20,42,25,27,14,1,19,22,86.4,3,27,19,8,28,70,53,1
37,Hayley Ladd,MF,Birmingham City,24,1993,18.8,54,40,18,33,3,15,19,78.9,4,22,3,19,37,91,25,0
38,Shania Hayles,"FW,MF",Birmingham City,18,1999,0.3,1,1,1,0,0,0,0,,0,1,0,1,0,1,1,0
39,Kerys Harrop,DF,Birmingham City,27,1990,18.1,39,22,30,7,2,18,26,69.2,8,29,10,19,23,62,70,0
40,Hannah Hampton,GK,Birmingham City,17,2000,12,1,0,1,0,0,1,2,50,1,0,0,0,0,1,8,2
41,Emma Follis,"FW,MF",Birmingham City,26,1992,15.3,21,11,5,8,8,7,23,30.4,16,15,0,15,9,30,4,0
42,Marisa Ewers,MF,Birmingham City,29,1989,6.6,12,4,2,9,1,3,9,33.3,6,7,1,6,15,27,5,0
43,Ann-Katrin Berger,GK,Birmingham City,27,1990,8,0,0,0,0,0,0,1,0,1,1,0,1,0,0,2,1
44,Chloe Arthur,MF,Birmingham City,23,1995,15.8,47,35,16,29,2,6,23,26.1,17,15,1,14,21,68,13,1
45,Victoria Williams,DF,Brighton,28,1990,19,28,15,23,5,0,13,24,54.2,11,26,11,15,36,64,75,3
46,Fern Whelan,"DF,MF",Brighton,29,1988,6.8,15,6,12,2,1,4,6,66.7,2,12,9,3,11,26,35,0
47,Aileen Whelan,"MF,FW",Brighton,26,1991,19.1,44,26,27,12,5,16,36,44.4,20,17,0,17,25,69,8,0
48,Iniabasi Umotong,FW,Brighton,24,1994,13.7,21,12,4,11,6,7,15,46.7,8,7,2,5,8,29,11,0
49,Emily Simpkins,MF,Brighton,28,1990,2.8,6,5,5,1,0,2,3,66.7,1,2,0,2,4,10,4,0
50,Bethan Roe,DF,Brighton,18,1999,2,3,1,2,0,1,3,4,75,1,0,0,0,0,3,6,0
51,Laura Rafferty,DF,Brighton,22,1996,13,22,11,16,5,1,8,17,47.1,9,20,11,9,14,36,47,0
52,Sophie Perry,"DF,MF",Brighton,31,1986,4.6,9,6,5,3,1,2,6,33.3,4,6,4,2,6,15,13,0
53,Chloe Peplow,MF,Brighton,19,1998,12.2,23,16,13,10,0,9,19,47.4,10,10,4,6,19,42,9,2
54,Amanda Nildén,"DF,MF",Brighton,19,1998,1.6,4,2,2,2,0,1,2,50,1,0,0,0,2,6,4,0
55,Kate Natkiel,"FW,MF",Brighton,25,1992,8.4,14,9,11,3,0,5,10,50,5,7,0,7,5,19,5,0
56,Jenna Legg,"MF,FW",Brighton,21,1997,1.2,0,0,0,0,0,0,0,,0,1,0,1,3,3,1,0
57,Maya Le Tissier,MF,Brighton,16,2002,1.4,1,1,1,0,0,1,2,50,1,0,0,0,2,3,1,1
58,Marie Hourihan,GK,Brighton,31,1987,13.4,0,0,0,0,0,0,2,0,2,0,0,0,0,0,6,3
59,Laura Hartley,GK,Brighton,,,1,0,0,0,0,0,0,0,,0,0,0,0,0,0,1,0
60,Sophie Harris,GK,Brighton,23,1994,3.6,0,0,0,0,0,0,0,,0,0,0,0,0,0,3,1
61,Eleanor Hack,DF,Brighton,16,2002,1,1,1,1,0,0,0,0,,0,1,0,1,0,1,7,0
62,Kayleigh Green,"MF,FW",Brighton,30,1988,17.1,31,18,15,13,3,6,27,22.2,21,18,1,17,31,62,17,0
63,Lucy Gillett,GK,Brighton,,,2,0,0,0,0,0,0,0,,0,0,0,0,0,0,0,1
64,Felicity Gibbons,DF,Brighton,24,1994,15.7,25,17,18,4,3,15,18,83.3,3,17,7,10,21,46,64,0
65,Megan Connolly,MF,Brighton,21,1997,6,7,5,3,3,1,3,10,30,7,6,3,3,9,16,9,0
66,Danielle Buet,"MF,DF",Brighton,29,1988,17.3,41,29,24,16,1,10,23,43.5,13,21,7,14,24,65,30,1
67,Jodie Brett,MF,Brighton,22,1996,6.2,12,6,7,5,0,1,4,25,3,7,1,6,3,15,3,0
68,Ellie Brazil,"FW,MF",Brighton,19,1999,15.8,51,33,17,25,9,17,32,53.1,15,35,2,33,20,71,13,0
69,Kirsty Barton,DF,Brighton,26,1992,15,35,22,26,9,0,17,31,54.8,14,16,7,9,24,59,55,1
70,Jessica Wooley,MF,Bristol City,17,2001,0.8,0,0,0,0,0,0,1,0,1,1,0,1,2,2,2,0
71,Poppy Wilson,MF,Bristol City,18,1999,0.1,0,0,0,0,0,0,0,,0,0,0,0,0,0,1,0
72,Ella Rutherford,"FW,MF",Bristol City,18,2000,16.2,42,28,16,16,10,9,19,47.4,10,32,4,28,23,65,20,0
73,Katie Rood,"FW,MF",Bristol City,25,1992,1.2,0,0,0,0,0,0,3,0,3,0,0,0,0,0,1,0
74,Katie Robinson,FW,Bristol City,15,2002,1.1,5,2,2,1,2,0,0,,0,1,0,1,0,5,1,0
75,Heather Payne,"FW,MF",Bristol City,18,2000,2.7,8,5,1,5,2,2,5,40,3,6,0,6,2,10,3,0
76,Poppy Pattinson,DF,Bristol City,18,2000,18.8,32,20,21,10,1,17,31,54.8,14,26,4,22,17,49,75,0
77,Danique Kerkdijk,DF,Bristol City,22,1996,17.3,17,11,11,5,1,4,7,57.1,3,21,16,5,29,46,87,1
78,Juliette Kemppi,FW,Bristol City,24,1994,9.7,1,1,1,0,0,0,1,0,1,2,1,1,3,4,4,0
79,Ali Johnson,DF,Bristol City,,,1.2,1,1,1,0,0,0,0,,0,1,0,1,3,4,7,0
80,Carla Humphrey,"MF,FW",Bristol City,21,1996,19.3,31,17,11,15,5,5,27,18.5,22,29,4,25,24,55,12,0
81,Abigail Harrison,"FW,MF",Bristol City,20,1997,7.2,7,5,4,2,1,1,10,10,9,10,1,9,7,14,4,0
82,Lucy Graham,"MF,FW",Bristol City,21,1996,19,22,13,8,11,3,7,31,22.6,24,14,2,12,19,41,20,0
83,Gemma Evans,DF,Bristol City,21,1996,17.1,32,23,23,9,0,13,21,61.9,8,24,11,13,25,57,128,2
84,Loren Dykes,DF,Bristol City,30,1988,19,27,15,24,1,2,10,21,47.6,11,17,11,6,15,42,83,0
85,Frankie Brown,"DF,MF",Bristol City,30,1987,19,13,3,6,7,0,2,7,28.6,5,24,16,8,20,33,87,1
86,Julie Biesmans,MF,Bristol City,24,1994,20,50,28,21,26,3,10,26,38.5,16,17,8,9,26,76,33,0
87,Sophie Baggaley,GK,Bristol City,21,1996,20,0,0,0,0,0,0,1,0,1,0,0,0,0,0,8,3
88,Rosella Ayane,"FW,MF",Bristol City,22,1996,8.8,14,8,4,7,3,2,9,22.2,7,5,0,5,5,19,0,0
89,Flo Allen,DF,Bristol City,18,1999,1.5,7,6,5,2,0,4,5,80,1,0,0,0,2,9,4,0
90,Maria Thorisdottir,"MF,DF",Chelsea,25,1993,3.4,4,1,0,3,1,2,5,40,3,3,0,3,3,7,2,0
91,Carly Telford,GK,Chelsea,31,1987,10,0,0,0,0,0,0,0,,0,0,0,0,0,0,3,1
92,Drew Spence,MF,Chelsea,25,1992,13.4,17,10,3,12,2,3,7,42.9,4,18,5,13,14,31,13,0
93,Ji So-yun,MF,Chelsea,27,1991,15.9,23,11,3,15,5,6,19,31.6,13,10,0,10,12,35,4,0
94,Ali Riley,"DF,FW",Chelsea,30,1987,3.9,6,4,3,3,0,3,3,100,0,0,0,0,4,10,10,0
95,Maren Mjelde,"DF,MF",Chelsea,28,1989,6.2,9,5,3,6,0,2,8,25,6,3,0,3,3,12,9,0
96,Hedvig Lindahl,GK,Chelsea,35,1983,9,0,0,0,0,0,0,1,0,1,0,0,0,0,0,8,1
97,Fran Kirby,"FW,MF",Chelsea,25,1993,10.7,6,6,1,3,2,4,6,66.7,2,4,0,4,4,10,1,0
98,Sophie Ingle,MF,Chelsea,26,1991,13.6,26,14,6,12,8,8,15,53.3,7,9,5,4,23,49,23,0
99,Magdalena Eriksson,DF,Chelsea,24,1993,19,15,9,6,9,0,1,2,50,1,10,5,5,18,33,73,1
100,Adelina Engman,"FW,MF",Chelsea,23,1994,4.3,4,2,1,1,2,1,6,16.7,5,16,0,16,1,5,2,0
101,Bethany England,FW,Chelsea,24,1994,12,14,7,2,6,6,4,9,44.4,5,24,3,21,9,23,7,1
102,Erin Cuthbert,"FW,MF",Chelsea,20,1998,15.5,44,24,6,22,16,10,21,47.6,11,30,2,28,18,62,3,0
103,Deanna Cooper,DF,Chelsea,25,1993,2.5,1,1,1,0,0,0,0,,0,1,1,0,1,2,2,0
104,Jess Carter,"DF,MF",Chelsea,20,1997,8.5,13,10,4,8,1,6,8,75,2,12,2,10,7,20,12,0
105,Karen Carney,"FW,MF",Chelsea,30,1987,10.9,6,2,0,4,2,0,4,0,4,8,2,6,1,7,2,0
106,Millie Bright,DF,Chelsea,24,1993,15.8,22,15,9,13,0,7,10,70,3,12,6,6,27,49,64,1
107,Hannah Blundell,"DF,FW",Chelsea,24,1994,13.3,16,9,10,5,1,8,12,66.7,4,8,1,7,15,31,8,0
108,Ann-Katrin Berger,GK,Chelsea,27,1990,1,0,0,0,0,0,0,0,,0,0,0,0,0,0,0,0
109,Jade Bailey,MF,Chelsea,22,1995,0.3,0,0,0,0,0,0,0,,0,0,0,0,0,0,0,0
110,Ramona Bachmann,"FW,MF",Chelsea,27,1990,11.9,13,7,4,5,4,4,5,80,1,8,0,8,7,20,1,0
111,Anita Asante,DF,Chelsea,33,1985,2.2,2,0,1,1,0,0,0,,0,0,0,0,0,2,1,0
112,Jonna Andersson,DF,Chelsea,25,1993,16.7,20,12,11,8,1,10,16,62.5,6,11,2,9,21,41,25,0
113,Siri Worm,DF,Everton,26,1992,9.5,19,14,14,5,0,9,14,64.3,5,6,2,4,11,30,38,0
114,Claudia Walker,FW,Everton,22,1996,4.6,4,2,1,1,2,0,2,0,2,2,0,2,1,5,0,0
115,Danielle Turner,"DF,MF",Everton,27,1991,12.5,17,14,11,5,1,7,14,50,7,14,5,9,12,29,34,0
116,Abbey-Leigh Stringer,MF,Everton,23,1995,13,34,23,15,16,3,11,28,39.3,17,18,1,17,19,53,20,0
117,Simone Magill,"FW,MF",Everton,23,1994,15.4,41,24,16,19,6,8,17,47.1,9,24,1,23,15,56,16,0
118,Kirstie Levell,GK,Everton,21,1997,20,1,1,1,0,0,1,1,100,0,0,0,0,0,1,18,3
119,Chloe Kelly,"MF,FW",Everton,20,1998,10.2,27,12,7,16,4,10,17,58.8,7,6,0,6,9,36,5,0
120,Inessa Kaagman,"MF,FW",Everton,22,1996,16.6,23,12,5,14,4,6,17,35.3,11,11,2,9,7,30,9,1
121,Angharad James,MF,Everton,24,1994,18,53,32,18,31,4,17,44,38.6,27,40,3,37,38,91,19,0
122,Elise Hughes,FW,Everton,17,2001,4.4,3,2,1,2,0,2,4,50,2,3,0,3,1,4,0,0
123,Taylor Hinds,DF,Everton,18,1999,10.8,29,20,13,11,5,13,23,56.5,10,6,1,5,15,44,26,0
124,Gabrielle George,DF,Everton,21,1997,15.2,23,19,19,3,1,9,16,56.3,7,25,20,5,17,40,96,0
125,Megan Finnigan,"DF,MF",Everton,20,1998,18.4,51,35,41,10,0,22,43,51.2,21,18,6,12,30,81,72,1
126,Olivia Chance,MF,Everton,24,1993,0,1,0,0,1,0,0,0,,0,0,0,0,0,1,0,0
127,Hannah Cain,"FW,MF",Everton,19,1999,6.8,8,6,5,0,3,2,6,33.3,4,8,1,7,2,10,2,0
128,Faye Bryson,"DF,MF",Everton,21,1997,5.9,24,16,15,5,4,14,23,60.9,9,6,1,5,10,34,22,0
129,Dominique Bruinenberg,MF,Everton,25,1993,6.8,26,15,4,21,1,8,20,40,12,6,1,5,16,42,5,0
130,Emma Brownlie,"DF,MF",Everton,24,1993,5,12,9,8,3,1,9,12,75,3,3,0,3,8,20,18,0
131,Georgia Brougham,DF,Everton,22,1996,16.2,25,13,24,1,0,12,18,66.7,6,21,18,3,18,43,84,1
132,Chantelle Boye-Hlorkah,"FW,DF",Everton,22,1995,10.5,21,14,6,6,9,8,21,38.1,13,9,1,8,14,35,17,0
133,Lauren Thomas,"MF,FW",Liverpool,,,0.2,0,0,0,0,0,0,0,,0,0,0,0,0,0,0,0
134,Courtney Sweetman-Kirk,"FW,MF",Liverpool,27,1990,14.9,30,18,6,20,4,10,23,43.5,13,12,2,10,5,35,18,0
135,Amy Rodgers,"MF,DF",Liverpool,18,2000,9.3,20,12,10,8,2,3,10,30,7,8,0,8,15,35,20,0
136,Rhiannon Roberts,"MF,DF",Liverpool,27,1990,5.7,24,15,12,12,0,7,11,63.6,4,10,6,4,12,36,20,1
137,Leigh-Anne Robe,DF,Liverpool,24,1993,19,90,62,66,21,3,27,42,64.3,15,29,8,21,37,127,94,0
138,Jemma Purfield,DF,Liverpool,21,1997,6,14,8,10,4,0,8,12,66.7,4,7,2,5,13,27,33,0
139,Anke Preuß,GK,Liverpool,25,1992,14,0,0,0,0,0,0,0,,0,0,0,0,0,0,12,4
140,Satara Murray,DF,Liverpool,25,1993,14,27,19,22,3,2,14,24,58.3,10,16,4,12,25,52,27,0
141,Christie Murray,MF,Liverpool,28,1990,14.4,40,26,11,24,5,14,20,70,6,10,0,10,23,63,12,0
142,Jasmine Matthews,DF,Liverpool,25,1993,9.9,20,10,16,4,0,5,6,83.3,1,10,9,1,16,36,70,0
143,Leandra Little,"DF,FW",Liverpool,33,1984,5,6,4,5,1,0,2,3,66.7,1,8,6,2,5,11,34,0
144,Kirsty Linnett,FW,Liverpool,24,1993,8.3,9,5,1,4,4,2,5,40,3,11,1,10,6,15,6,0
145,Frances Kitching,GK,Liverpool,20,1998,6,0,0,0,0,0,0,0,,0,0,0,0,0,0,3,1
146,Simran Jhamat,"MF,FW",Liverpool,17,2001,0.5,3,2,1,2,0,1,1,100,0,2,1,1,1,4,1,0
147,Ashley Hodson,"MF,FW",Liverpool,23,1995,1.2,1,1,0,1,0,1,2,50,1,2,0,2,0,1,1,0
148,Niamh Fahey,"MF,DF",Liverpool,30,1987,14.2,28,17,15,12,1,6,18,33.3,12,16,9,7,20,48,69,0
149,Yana Daniels,"MF,FW",Liverpool,26,1992,7.9,13,9,6,5,2,7,17,41.2,10,16,3,13,4,17,16,0
150,Laura Coombs,MF,Liverpool,27,1991,19.9,45,29,19,23,3,9,27,33.3,18,7,0,7,15,60,12,0
151,Jessica Clarke,"FW,MF",Liverpool,29,1989,11.3,8,7,1,4,3,3,5,60,2,5,0,5,6,14,7,0
152,Niamh Charles,"FW,MF",Liverpool,19,1999,6.4,11,6,3,6,2,1,5,20,4,11,0,11,5,16,7,0
153,Sophie Bradley,DF,Liverpool,28,1989,20,23,15,19,4,0,8,11,72.7,3,25,21,4,29,52,183,1
154,Missy Bo Kearns,"MF,FW",Liverpool,17,2001,0.2,0,0,0,0,0,0,0,,0,0,0,0,0,0,0,0
155,Annabel Blanchard,FW,Liverpool,17,2001,0.1,0,0,0,0,0,0,0,,0,0,0,0,0,0,0,0
156,Rinsola Babajide,"MF,FW",Liverpool,20,1998,11.1,31,21,14,12,5,3,5,60,2,12,0,12,11,42,13,0
157,Tessa Wullaert,"FW,MF",Manchester City,25,1993,13.9,28,19,11,14,3,9,22,40.9,13,21,3,18,11,39,5,0
158,Caroline Weir,"MF,FW",Manchester City,23,1995,15,25,12,8,9,8,6,12,50,6,21,3,18,13,38,3,0
159,Keira Walsh,MF,Manchester City,21,1997,19,35,20,16,16,3,12,24,50,12,19,4,15,20,55,17,0
160,Demi Stokes,DF,Manchester City,26,1991,10.2,18,13,10,4,4,6,8,75,2,10,1,9,7,25,15,0
161,Georgia Stanway,"MF,FW",Manchester City,19,1999,14.6,24,16,8,12,4,8,25,32,17,23,1,22,14,38,12,0
162,Jill Scott,MF,Manchester City,31,1987,17.5,54,33,17,26,11,13,31,41.9,18,24,2,22,29,83,16,0
163,Ellie Roebuck,GK,Manchester City,18,1999,15,1,1,1,0,0,0,0,,0,0,0,0,0,1,2,1
164,Nikita Parris,FW,Manchester City,24,1994,17.7,12,8,1,6,5,1,10,10,9,20,0,20,6,18,5,0
165,Jessica Park,"FW,MF",Manchester City,16,2001,0.4,1,1,1,0,0,0,0,,0,0,0,0,0,1,0,0
166,Nadia Nadim,FW,Manchester City,30,1988,1.9,4,4,0,1,3,0,0,,0,2,1,1,0,4,0,0
167,Esme Morgan,DF,Manchester City,17,2000,5.3,9,6,4,4,1,5,8,62.5,3,5,1,4,5,14,14,0
168,Abbie McManus,DF,Manchester City,25,1993,10.1,23,15,11,11,1,7,9,77.8,2,15,3,12,15,38,15,1
169,Melissa Lawley,FW,Manchester City,24,1994,2.4,2,1,0,1,1,0,0,,0,2,0,2,0,2,0,0
170,Steph Houghton,DF,Manchester City,30,1988,20,29,20,12,17,0,12,19,63.2,7,23,16,7,18,47,84,3
171,Lauren Hemp,"FW,MF",Manchester City,17,2000,6.7,6,4,1,1,4,0,4,0,4,6,0,6,3,9,1,0
172,Claire Emslie,"FW,MF",Manchester City,24,1994,7.2,13,6,4,6,3,2,6,33.3,4,8,0,8,2,15,2,0
173,Megan Campbell,DF,Manchester City,25,1993,2,4,3,2,2,0,1,3,33.3,2,4,0,4,0,4,3,0
174,Pauline Bremer,FW,Manchester City,22,1996,1.3,0,0,0,0,0,0,1,0,1,0,0,0,1,1,0,0
175,Gemma Bonner,DF,Manchester City,27,1991,14.5,28,17,13,13,2,7,13,53.8,6,22,8,14,19,47,29,0
176,Janine Beckie,FW,Manchester City,23,1994,3.2,2,2,0,2,0,0,1,0,1,2,0,2,0,2,3,0
177,Jennifer Beattie,DF,Manchester City,27,1991,17,22,14,15,7,0,4,6,66.7,2,16,12,4,16,38,51,2
178,Karen Bardsley,GK,Manchester City,33,1984,5,0,0,0,0,0,0,0,,0,0,0,0,0,0,1,3
179,Lily Woodham,"DF,MF",Reading,17,2000,1.7,2,1,1,1,0,2,3,66.7,1,0,0,0,0,2,2,0
180,Fara Williams,"MF,FW",Reading,34,1984,19.2,16,13,4,7,5,5,11,45.5,6,7,1,6,9,25,8,0
181,Rachel Rowe,MF,Reading,25,1992,0.8,4,2,0,1,3,1,1,100,0,0,0,0,1,5,1,0
182,Jo Potter,DF,Reading,33,1984,16,19,13,16,3,0,9,12,75,3,15,10,5,14,33,45,0
183,Kirsty Pearce,DF,Reading,,,16.9,22,15,16,6,0,10,22,45.5,12,11,6,5,23,45,71,3
184,Mayumi Pacheco,DF,Reading,19,1998,14,43,28,21,13,9,12,24,50,12,16,2,14,22,65,23,0
185,Jade Moore,"MF,FW",Reading,27,1990,10.8,28,16,5,17,6,10,15,66.7,5,12,4,8,16,44,12,1
186,Grace Moloney,GK,Reading,25,1993,20,0,0,0,0,0,0,1,0,1,0,0,0,0,0,11,3
187,Rebecca Jane,DF,Reading,26,1992,4.1,8,3,7,1,0,2,6,33.3,4,3,2,1,3,11,7,0
188,Sophie Howard,"DF,MF",Reading,24,1993,4.4,9,3,5,4,0,4,7,57.1,3,3,1,2,12,21,23,0
189,Rakel Hönnudóttir,"FW,MF",Reading,29,1988,2.3,4,4,1,1,2,0,1,0,1,5,2,3,2,6,1,0
190,Natasha Harding,DF,Reading,29,1989,19,28,16,13,8,7,9,32,28.1,23,18,4,14,22,50,29,0
191,Rachel Furness,MF,Reading,30,1988,16.6,32,16,8,20,4,12,40,30,28,11,3,8,22,54,23,0
192,Millie Farrow,FW,Reading,22,1996,1.6,2,2,0,0,2,1,2,50,1,2,0,2,0,2,0,0
193,Charlie Estcourt,"MF,FW",Reading,20,1998,3.4,1,1,0,0,1,0,3,0,3,5,0,5,3,4,4,0
194,Gemma Davison,"FW,MF",Reading,31,1987,9.3,9,4,2,5,2,0,3,0,3,2,1,1,3,12,0,0
195,Brooke Chaplen,"FW,MF",Reading,29,1989,15.3,11,7,1,3,7,1,9,11.1,8,7,0,7,5,16,0,0
196,Lauren Bruton,"FW,MF",Reading,25,1992,14.7,26,16,4,13,9,4,21,19,17,13,1,12,7,33,2,0
197,Molly Bartrip,"DF,MF",Reading,22,1996,8.4,19,14,11,8,0,6,10,60,4,5,3,2,12,31,34,0
198,Jade Bailey,"MF,FW",Reading,22,1995,3.2,7,5,5,2,0,3,5,60,2,5,0,5,3,10,7,0
199,Remi Allen,MF,Reading,27,1990,18.4,52,38,18,26,8,14,37,37.8,23,35,4,31,18,70,21,0
200,Brianna Visalli,"MF,FW",West Ham,23,1995,15.5,49,33,20,22,7,9,27,33.3,18,15,1,14,14,63,11,1
201,Rebecca Spencer,GK,West Ham,27,1991,11,0,0,0,0,0,0,1,0,1,1,0,1,0,0,12,5
202,Cho So-hyun,MF,West Ham,30,1988,6.3,14,6,3,9,2,1,10,10,9,9,2,7,3,17,9,0
203,Erin Simon,DF,West Ham,23,1994,15.5,32,20,22,9,1,15,24,62.5,9,10,3,7,29,61,57,0
204,Julia Simic,MF,West Ham,29,1989,10.1,17,9,8,9,0,6,16,37.5,10,13,2,11,13,30,1,0
205,Vyan Sampson,"DF,MF",West Ham,22,1996,5.3,3,2,1,2,0,2,2,100,0,2,0,2,8,11,19,0
206,Jane Ross,FW,West Ham,28,1989,18.4,15,8,2,10,3,4,10,40,6,20,2,18,4,19,11,0
207,Lucienne Reichardt,"MF,DF",West Ham,27,1991,8.6,17,11,8,8,1,6,13,46.2,7,13,3,10,12,29,8,0
208,Claire Rafferty,DF,West Ham,29,1989,11.6,15,9,8,5,2,6,11,54.5,5,10,1,9,32,47,41,1
209,Ria Percival,"DF,MF",West Ham,28,1989,15.2,45,30,27,14,4,14,23,60.9,9,16,6,10,38,83,46,1
210,Anna Moorhouse,GK,West Ham,23,1995,8.9,1,1,1,0,0,0,1,0,1,0,0,0,0,1,8,2
211,Kate Longhurst,"MF,DF",West Ham,29,1989,17.7,20,11,5,13,2,5,13,38.5,8,23,10,13,23,43,17,0
212,Adriana Leon,"FW,MF",West Ham,25,1992,3.9,9,7,3,3,3,3,6,50,3,6,0,6,3,12,1,0
213,Alisha Lehmann,"FW,MF",West Ham,19,1999,19.1,27,14,10,10,7,4,16,25,12,17,1,16,14,41,5,0
214,Rosie Kmita,"FW,MF",West Ham,24,1994,2.5,2,1,1,1,0,1,3,33.3,2,2,0,2,5,7,4,0
215,Leanne Kiernan,"FW,MF",West Ham,19,1999,10.2,17,10,4,7,6,8,16,50,8,6,0,6,5,22,3,0
216,Brooke Hendrix,DF,West Ham,25,1993,13.4,12,8,6,6,0,2,8,25,6,16,11,5,28,40,76,1
217,Esmee de Graaf,"FW,DF",West Ham,20,1997,7.2,7,2,3,4,0,3,3,100,0,10,1,9,7,14,13,0
218,Gilly Flaherty,DF,West Ham,26,1991,19,22,13,13,7,2,9,13,69.2,4,21,15,6,43,65,96,1
219,Megan Walsh,GK,Yeovil Town,23,1994,20,2,2,2,0,0,2,4,50,2,0,0,0,0,2,14,2
220,Charlie Taylor,FW,Yeovil Town,,,0.1,0,0,0,0,0,0,0,,0,0,0,0,0,0,0,0
221,Emily Syme,"MF,FW",Yeovil Town,18,2000,8.6,6,3,2,4,0,2,11,18.2,9,5,2,3,3,9,11,0
222,Hannah Short,DF,Yeovil Town,25,1993,17.2,39,22,32,7,0,16,27,59.3,11,34,18,16,37,76,126,0
223,Liberty Piggott,FW,Yeovil Town,20,1997,0,0,0,0,0,0,0,0,,0,0,0,0,0,0,0,0
224,Rachel McLauchlan,"MF,DF",Yeovil Town,21,1997,7,30,17,16,10,4,9,20,45,11,18,5,13,11,41,35,1
225,Ellie Mason,"DF,MF",Yeovil Town,22,1996,18.7,41,19,31,8,2,16,31,51.6,15,23,13,10,42,83,130,2
226,Bonnie Horwood,MF,Yeovil Town,31,1987,16.4,30,17,8,22,0,6,14,42.9,8,19,5,14,20,50,43,2
227,Ann-Marie Heatherson,"MF,FW",Yeovil Town,34,1984,18.5,53,31,17,28,8,14,32,43.8,18,25,1,24,15,68,33,0
228,Amy Goddard,DF,Yeovil Town,,,9.8,28,21,19,7,2,16,29,55.2,13,16,4,12,21,49,51,0
229,Amber Gaylor,"MF,FW",Yeovil Town,23,1995,9,26,17,12,8,6,4,16,25,12,12,1,11,3,29,13,0
230,Monique Fischer,MF,Yeovil Town,26,1991,1.7,1,1,1,0,0,0,0,,0,0,0,0,4,5,2,0
231,Olivia Fergusson,FW,Yeovil Town,23,1995,18.4,15,10,4,5,6,6,16,37.5,10,9,1,8,4,19,2,0
232,Georgia Evans,MF,Yeovil Town,22,1995,15.6,30,21,22,8,0,7,23,30.4,16,19,7,12,19,49,30,4
233,Emily Donovan,"MF,FW",Yeovil Town,,,9.1,15,9,9,5,1,7,16,43.8,9,11,1,10,8,23,7,0
234,Nicola Cousins,DF,Yeovil Town,29,1988,14.6,34,19,25,8,1,12,20,60,8,25,15,10,41,75,104,3
235,Charlotte Buxton,DF,Yeovil Town,,,6,21,12,14,6,1,3,13,23.1,10,4,3,1,14,35,27,0
236,Leah Burridge,MF,Yeovil Town,,,0.3,0,0,0,0,0,0,2,0,2,1,1,0,0,0,1,0
237,Erin Bloomfield,"FW,MF",Yeovil Town,,,5,7,6,0,3,4,2,6,33.3,4,2,0,2,1,8,2,0
238,Megan Alexander,DF,Yeovil Town,24,1993,20,30,16,17,12,1,10,13,76.9,3,22,13,9,18,48,89,0
239,Shannon Albuery,"FW,MF",Yeovil Town,,,3.6,3,0,0,1,2,0,0,,0,1,0,1,1,4,1,0